XXXXXXXXXXXXXXXXXXXXXXXXXXXXXXXXXXXXXXXXXXXXXXXXXXXXXXXXXXXXXXXXXXXXXXXXXXXXXXXXXXXXXXXXXXXXXXXXXXXX
X    @      X      X LDRXXLDR X     XX           X                 X                    X          X
X           X      X  C XX C  X     XX           X   C         C   X   C           C    X          X
X           X      X    XX    X     XX           X  LDR       LDR  X  LDR         LDR   X          X
X   C C C   X           XX          XX           XXXXXXXXXX  XXXXXXXXXXXXXXXXX  XXXXXXXXXXXXX   XXXX
X  LDDDDDR  X           XX               C   C                                                     X
X   C C C   X           XX              LDDDDDR                                                    X
X           X      XXXXXXXXXXXX     XX   C   C   X         XXXXXXXXXXXXXXXXXXXXXXXXXXX             X
X                       XX          XX           X         XXXXXXXXXXXXXXXXXXXXXXXXXXX             X
X                       XX          XX           X                                                 X
X           X      X    XX    X     XXXXXXXXXXXXXX                                                 X
X   C C C   X      X  C XX C  X     XXXXXXXXXXXXXX      XXXXXXXXXXXXXXXXXXXXXXXXXXXXXX             X
X  LDDDDDR  X      X LDRXXLDR X     XX           X      X                            X             X
X   C C C   X      XXXXXXXXXXXX     XX           X      X             X              X             X
X           X      X LDRXXLDR X     XX           X      X           LRXLR            X             X
X           X      X    XX    X     XX   C C C   X      X           XXXXX            X             X
XXXXXX  XXXXX      X    XX    X         LDDDDDR         X           LRXLR            X             X
X   X                   XX                 C            X             X              X             X
X   X                   XX          XX           X      X                            X             X
X                  XXXXXXXXXXXX     XX           X      X             C              X             X
XXXXX                               XX           X      X            LDR             X             X
X                                   XX           X      X                            X             X
X   X                               XX           X      XXXXXXXXXXXX     XXXXXXXXXXXXX             X
X   X                               XXXXXXXXXXXXXX                                                 X
XXXXXXXXXXXXXXXX                    XXXXXXXXXXXXXX                                                 X
X              X         XXX     XXXXXXXXXXXXXXXXXXXXXXX    XXXXXXXXXXXXXXX                        X
X              X         X        X                   X                   X                        X
X              X         X        X                   X                   X                        X
X                        X        X     LDDDDDDDDDR   X                   X                        X
X                        X        XX    XXXXXXXXXXX  XX                   X                        X
X              X         X                                                                         X
X              X         X       C C C C C                    C C C                                X
X              X                LDDDDDDDDDR                   LDDDDR                               X
XXXXXXXXXXXXXXXX                 C C C C C      C C C C        C C C                               X
X              X                              LDDDDDDDDR                  X                        X
X              X                               C C C C                    X                        X
X              X         X                                                X                        X
X              X         X       C C C C                      C C C       X                        X
X                        X      LDDDDDDDDR                    LDDDDR      X                        X
X                                C C C C                       C C C      X                        X
X              X                               C C C C C                  X                        X
X              X                              LDDDDDDDDDR                 X                        X
X              X                               C C C C C                  X                        X
XXXXXXXXXXXXXXXX         X                                                X                        X
X                        X         C C C C                  C C C C                                X
X                        X        LDDDDDDDR                 LDDDDDDR                               X
X                        X        C C C C C                 C C C C                                X
X                        X                                                                         X
X                        X                                                X                        X
X                        XXXXXXXXXXXX    XXXXXXXXXXXXXXXXXXXXX    XXXXXXXXX                        X
X                                        X                   X                                     X
X                                        X         C         X                                     X
X                                        X       LDDDR       X                                     X
X                                        X                   X                                     X
X                                        XXXXXXXXX    XXXXXXXX                                     X
X                                                                                                  X
X                                                                                                  X
X                                                                                                  X
X                        v                                                                         X
X                                                                                                  X
X                                                                                                  X
X                                                                                                  X
X                                                                                                  X
X                                                                                                  X
X                                                                                                  X
X                                                                                                  X
X                                                                                                  X
X                                                                                                  X
X                                                                                                  X
X                                                                                                  X
X                                                                                                  X
X                                                                                                  X
X                                                                                                  X
X                                                                                                  X
X                                                                                                  X
X                                                                                                  X
X                                                                                                  X
X                                                                                                  X
X                                                                                                  X
X                                                                                                  X
X                                                                                                  X
X                                                                                                  X
X                                                                                                  X
X                                                                                                  X
X                                                                                                  X
X                                                                                                  X
X                                                                                                  X
X                                                                                                  X
X                                                                                                  X
X                                                                                                  X
X                                                                                                  X
X                                                                                                  X
X                                                                                                  X
X                                                                                                  X
X                                                                                                  X
X                                                                                                  X
X                                                                                                  X
X                                                                                                  X
X                                                                                                  X
XXXXXXXXXXXXXXXXXXXXXXXXXXXXXXXXXXXXXXXXXXXXXXXXXXXXXXXXXXXXXXXXXXXXXXXXXXXXXXXXXXXXXXXXXXXXXXXXXXXX
